#Example: Large parts of Africa and south east Asia
tropical = {
	
}

arid = {
	
}

arctic = {
	
}

#Example: Most of Europe north of med.
mild_winter = {
	
}

#Example: Inland Europe & Scandinavia
normal_winter = {
	
}

#Example: Russia & Lappland
severe_winter = {
	
}

mild_monsoon = {

}

normal_monsoon = {

}

severe_monsoon = {

}

impassable = {
	3972 2488 4432 270 4456 1578 1142 4338 533 2421 3802 4184 4570 1562 1420
    2580 1222 4604 3353 4614 2298 230 2244 2436 978 3931 1185 4046 683 274 2363 3602
    2054 707 4720 1331 3994 2611 4758 954 939 3676 478 161 2961 3167 4820 819 1697 1906 
    2056 3491 834 4127 1817 4282 2478 1270 3824 1830 4930 694 4053 3218 968 4239 2619 1316
    4988 3414 5015 3932 867 928 3661 3274 2981 4457 2414 4483 465 2089 4520 
    
    1485 3952 354 5026 1366 3976 1966 4005 3178 4954 1453 4937 2448 3037 2530 942 4889 2656
    3006 1808 4851 3501 3270 1137 1558 3224 2907 449 4771 4089 1199 79 3208 2599 4714 3558 
    2980 3646 2821 2765 3498 4654 2704 4634 1646 397 4618 4602 4598 4074 4119 1109 4550 558 
    1699 4106 2722 2888 4497 593 3447 2306 4185 3677 953 2227 4065 812 4344 
    
}
